durchzuführen: effectuer, réaliser, mener
barmherzlich: misércordieux, chaleureux
überwältigt: accablé, submergé, dépassé
überwinden: surmonter
prekär: précaire
anspornen, anreizen: inciter, encourager
aufgeregt, begeistert: excité, heureux
wütend: en colère, fâché, furieux
ausgelastet: occupé, saturé
bekommen zu spüren: commence à sentir
spüren: sentir
knapp, ungefähr: presque, près
zügeln: maîtriser
Austauch: échange
Angabe: spécification
Schichten: couches
selbsterklärend: self explanatory
gegenwart, heutzutage: de nos jours, ces jours-ci
begeben: embarquer, se diriger vers (Bitte begeben Sie sich umgehend zu Ausstieg A)
festigen: consolider, renforcer
betreuen: s'occuper de. Betreuung: soin
traumhaft, atemberaubend: magnifique
abscheulich: odieux, abominable, affreux
angehen: approcher, aborder (par exemple un problème)
zweifel (m.): doute
beschwerden: malaise
erwähnen: mentionner
wohltat (f.): bienfait
beschwerde (f): une plainte
unternehmen (m.): entreprise, entreprendre, poursuivre
bescheiden: modeste
eigentlich: en réalité
außerdem, darüber hinaus: en outre
verbringen: passer (de temps), dépenser
entkommen, entgehen: s'échapper
fliehen: fuir
berufsverkehr (m.): heure de pointe
umfangreichen: étendu, vaste
ausblenden: masquer, cacher
verstecken, verbergen: cacher
aufgaben (f.): Tâches
schritt (m.), schritte: étapes
übersetzen: traduire
unterstützen: soutenir, aider (se dit d'une personne ou quelquechose concrète)
stützen: soutenir (un thèse, une déclaration)
erleichtern: soulager
dringend: urgemment, d'urgence
empfang (m.): réception
Begrüßung (f.): accueil, Begrüßung zum Empfang
gemütliche: chaleureux
gut gelaunt: de bonne humeur
wahrheit (f.): vérité
beifall (m.): applaudissement
verschlechtern: s'empirer, détériorer
vor kurzem: récemment
zugeben: admettre
unfassbar: incomprehensible
gegenseitig: mutuel
erläutern, erklären: expliquer
einzelheiten: détails
ausführlicher: plus en détail
herausforderung: défi
die ungerechtigkeit, das unrecht: injustice
kassieren: collecter
bejubelt: acclamé
einführung: mise en place, adoption
aktualisieren: mettre à jour
betonen: mettre l'accent sur
abwehren: repousser
der bereich: zone, domaine
schwelgen: ressasser, se vautrer
voraussichtlich, wahrsheinlich: vraisemblablement
vorherigen, vorhergehend, vorig: précédent
verraten: offenbaren, zeigen, enthüllen, aufdecken
geeignet: passend (adapté, approprié)
scheidung: divorce (die begriffliche Scheidung von Neonazismus und Neofaschismus. Die Scheidung aussprechen)
überwältigend: accablante, bouleversant
aufsetzen, anziehen: enfiler
ausziehen: déshabiller, enlever
beitreten: joindre
beteiligen: participer (aktiv teilnehmen (an etwas), mitwirken)
beitragen: contribuer (etwas zu jemandes Erfolg beitragen)
trauung, hochzeit, heirat: un mariage
vereinbarung, abmachung, zustimmung: une entente, un accord (Vereinbaren von etwas)
auslösen: déclencher
einzuhalten: respecter, se conformer
unbeaufsichtigt (beaufsichtigen): sans surveillance (surveiller)
genehmigung, zulassung, erlaubnis: autorisation
Beschränkungen, einschränkungen: limitations, restrictions
hervorrufen, aufrufen, wachrufen: évoquer
das benehmen, die verhaltung, die einstellung: comportement
fortschrittlich, fortschreitend, vorwärtsgerichtet: progressive
unerheblich: hors de propos, hors du sujet
überheblich: arrogant, autoritaire
eingebildet: vaniteux
reinigen, rein: nettoyer, pur
auseinandersetzung: affrontement
der streit: argument
(geld) abheben und einzahlen: tirer et verser de l'argent 
herrschen, vorherrschen: regner, prévaloir
anscheinend, offenbar: apparement
bedenken: réfléchir
unleugbar, unbestreitbar: indéniable, incontestable
rücksichtsvoll: prévenant
genesung, erholung: récupération 
beiseitelegen: mettre à coté
schweigen: se taire, garder sa silence
das Schweigen: la silence
aufwerfen: soulever (se dit d'une question)
ablehnend, abwertend, missbilligend: désapprobateur, désapprobatrice
abwerten: dévaloriser
hinweisen: indiquer
berücksichtigen: prendre en compte
berechtigt: éligible, admissible
berechtigen: genehmigen, gestatten, autorisieren
zögernd: hésitant
zuversichtlich: optimiste
verringern: réduire
verderben: gâcher
Umfang: portée, étendue
gewähren: accorder
abwicklung: achèvement, accomplissement
umziehen: déménager
einziehen: emménager
entsprechend: par conséquent
Wurzeln: racines
ausbleiben: rester loin, rester à l'écart
ausstehend, fällig, gebührend: dû
erweisen: montrer, prouver
leisten: accomplir, réaliser
verheerend: dévastateur
vorausgesetzt, versehen: fourni
beachtlich, deutlich, wesentlich, erheblich: significativement
sprunghaft, unberechenbar: erratique
unvorhersehbar: imprévisible
beeinträchtigen: interférer
bestechen: soudoyer, Bestechung: pot-de-vin
beschlagnahmen: konfiszieren, confisquer
risikobereitschaft: volonté-disposition à prendre de risques
einleiten: lancer, initier
zustoßen: survenir, se passer
ergreifen: saisir
unentbehrlich, unabkömmlich: indispensable, essentiel
errungenschaft (die): un accomplissement
schmachten: languir, dépérir
gegebenfalls: le cas échéant
vernehmlich, hörbar: claire (se dit d'un son)
unverkennbar: indubitable
vertretbar: haltbar, soutenable
breitgefächert: d'une gamme vaste, weitreichend
imstande: en mesure, capable. Sie sind kaum imstande, ihre wahre Identität zu finden. 
zwanghaft: compulsif
Nachahmen: imiter 
zugrundeliegend: grundlegend, tiefer liegend, sous-jacente
durchziehen, durchhalten: persévérer, persister
klapprig: alt, durch längeren Gebrauch abgenutzt und nicht mehr sehr stabil, intakt. Rachitique, rabougri
verkümmert: atrophié, rabougri (peu développé)
hervorstechend: prominent, éminent 
Charakterzug (der): trait de caractère
verachten: mépriser
einen Durchhänger haben: keine Energie haben, lust und kraftlos sein
schrumpfen: kleiner wirden
schwinden:dwindle, diminuer
Zwietracht (die):  Unenigkeit, der Streit
polieren: peaufiner
gammeln: faulenzen, sich flach hinlegen
herablassend, herabwürdigend (herablassen, herabwürdigen): condescendant
unterbinden: prévenir, empêcher
einschüchtern: intimider
Frust (der): frustration
Hürde (die): das Hindernis, un obstacle
Holprig: 1) höckerig, uneben 2) stockend, cahoteux
ausser sich vor Freude: extrêmement heureux
verdreifachen: tripler
Teufelskreis (der): le cercle vicieux
Kaninchenbau (der): trou de lapin 
ableiten: déduire
knallhart: unerbittlich (sans relâche) die ganze Kraft eines Menschen beanspruchend; den ganzen persönlichen Einsatz erfordernd. unerbittlich hart, rücksichtslos bis zur Brutalität
verdrängen: supprimer, refouler, réprimer, remplacer
Verdrängungswettbewerb (der): compétition acharnée
einschreiten: eingreifen, intervenir 
den Dreh rausbekommen: get the hang of things
missverständlich, irreführend: trompeur, misleading
vervollständigen: ausführen, erledigen, abgeschlossen
unverhohlen: flagrant Z.B: zu unverhohlen seine Machtspielchen zu treiben
erklimmen: grimper
Ressentiment (die): Ressentiment, DE: Groll, Hasse
einschmeichelnd: insinuant
besorgniserregend, beunruhigend: inquiétante
Sonderfall: cas particulier
sich brüsten: prahlen, angeben
unversehrt: unbeschadet, intakt
hinterhältig: hinterlistig, sournois
etwas auf Anhieb verstehen: comprendre immédiatement
auf Kritik stoßen: rencontrer des critiques
sich erweisen als: s'avère être
allmählich: progressivement
Größenwahn (der): la mégalomanie
unsäglich: unaussprechlich, unsagbar, indicible
ausstreichen: supprimer
abwenden: éviter, avert
missgönnen: beneiden, envier
Umgangsform (die): les moeurs
Durchsage: Ankündigung
entheben: virer qqn de son poste
sich anschallen: Attacher la ceinture
verbummeln, vertrödeln: laze away, rester inactif
unbekümmert: insouciant
erwidern: répondre
unablässig: unaufhörlich, unerbittlich, sans cesse 
ungebeten: sans invitation, sans y être invité
Gewöhnungsbedürftig: beschreibt etwas, an das man sich erst gewöhnen muss. Décrit quelque chose qui nécessite du temps pour s'y habituer.
reibungslos: sans frottement (sans problèmes)
Anmut (die): die Gnade. Sie bewegte sich mit müheloser Anmut durch das Wasser